111111111
100100001
100001001
1P0011E01
100001111
100001111
100001111
100001111
111111111