1111111111111
1001000000001
1000011111001
1800119000001
1111111111111