1111111111111
1001000000001
1000001111001
1800119000001