1111111111111
1E1100P0000C1
1010011111001
1000110000001
1111111111111