1111111111111
1E110000000C1
1010011111001
1P0011E000001
1111111111111