1111111111111
1E11ECP000001
1010011111001
1000110000001
1111111111111