1111111111111111111111111111111111
1E00000000000000000000000000000001
1000010010101010001000000000010101
1010010010101010001001000000010101
1010010010101010001001000000010101
1010010010101010001001000000010101
1010010010101010001001000000010101
1010010010101010001001000000010101
1010010010101010001001000000C10101
100000000000000000000000000P000001
1111111111111111111111111111111111