1111111111111111111111111111111111
100000PE00000000000000000000000001
100001C010101010001000000000010101
1010010010101010001001000000010101
1010010010101010001001000000010101
1010010010101010001001000000010101
1010010010101010001001000000010101
1010010010101010001001000000010101
101001001010101000100100000E101001
1000000000000000000000000000C00001
1111111111111111111111111111111111